Id,R,Nome,Squadra,Qt. A,Qt. I,Diff.
2610,Pc,RONALDO,Juventus,49,48,1
785,Pc,IMMOBILE,Lazio,45,49,-4
2531,Pc,LUKAKU,Inter,42,42,0
608,Pc,ZAPATA D.,Atalanta,40,40,0
2819,Pc,CAPUTO,Sassuolo,36,34,2
2530,Pc,IBRAHIMOVIC,Milan,35,35,0
26,T;A,GOMEZ,Atalanta,33,29,4
2764,Pc,MARTINEZ L.,Inter,32,30,2
441,Pc,BELOTTI,Torino,30,29,1
309,A,DYBALA,Juventus,30,31,-1
647,Pc,DZEKO,Roma,29,31,-2
531,A,BERARDI,Sassuolo,29,27,2
507,Pc,MURIEL,Atalanta,27,26,1
410,Pc,MERTENS,Napoli,27,25,2
2002,W;A,CHIESA,Juventus,26,25,1
2833,T;A,KULUSEVSKI,Juventus,26,26,0
2160,E,GOSENS,Atalanta,26,24,2
1874,A,JOAO PEDRO,Cagliari,26,25,1
186,A,REBIC,Milan,26,27,-1
177,A,ILICIC,Atalanta,25,27,-2
2085,T,LUIS ALBERTO,Lazio,24,25,-1
2194,T,CALHANOGLU,Milan,24,24,0
4661,Pc,OSIMHEN,Napoli,24,24,0
2475,A,SANCHEZ,Inter,24,24,0
409,A,INSIGNE,Napoli,24,23,1
2529,T;A,MKHITARYAN,Roma,23,24,-1
2012,Pc,MILIK,Napoli,23,24,-1
313,Pc,MORATA,Juventus,23,24,-1
4160,Dd;Ds;E,HAKIMI,Inter,23,22,1
568,Pc,QUAGLIARELLA,Sampdoria,22,20,2
4292,Ds;E,HERNANDEZ T.,Milan,22,21,1
2719,A,BARROW,Bologna,22,23,-1
467,C;T,NAINGGOLAN,Inter,21,22,-1
495,A,CORREA,Lazio,21,23,-2
1996,T,DE PAUL,Udinese,20,20,0
645,C;T,MILINKOVIC-SAVIC,Lazio,20,19,1
2832,A,BOGA,Sassuolo,20,22,-2
2489,W;A,PEDRO,Roma,19,18,1
2414,C,VIDAL,Inter,19,19,0
2061,Pc,SIMEONE,Cagliari,18,19,-1
2841,Pc,VLAHOVIC,Fiorentina,18,18,0
2409,A,RIBERY,Fiorentina,18,18,0
2167,W;A,ORSOLINI,Bologna,17,18,-1
5001,T;A,MIRANCHUK,Atalanta,17,18,-1
453,Por,SZCZESNY,Juventus,17,17,0
350,Por,DONNARUMMA G.,Milan,17,16,1
2077,C;T,PASALIC,Atalanta,17,16,1
4377,C;T,CASTROVILLI,Fiorentina,17,15,2
2762,A,KOUAME',Fiorentina,17,17,0
2287,W;T,RAMIREZ,Sampdoria,16,17,-1
4427,T,MALINOVSKYI,Atalanta,16,15,1
2766,T,ZANIOLO,Roma,16,17,-1
250,Por,HANDANOVIC,Inter,16,18,-2
827,M;C,LOCATELLI,Sassuolo,16,14,2
367,C;W;T,BONAVENTURA,Fiorentina,16,16,0
2625,C;T,SORIANO,Bologna,16,14,2
2215,C,VERETOUT,Roma,16,14,2
4825,W;T,DIAZ B.,Milan,15,14,1
2556,T,ERIKSEN,Inter,15,16,-1
1939,Pc,LAPADULA,Benevento,15,14,1
2284,Pc,CAICEDO,Lazio,15,15,0
407,Pc,GABBIADINI,Sampdoria,15,16,-1
90,Pc,LASAGNA,Udinese,15,17,-2
2214,Ds;Dc;E,KOLAROV,Inter,15,16,-1
581,Dd;E,FARAONI,Verona,15,15,0
322,Dc,DE VRIJ,Inter,15,15,0
513,Dc,ACERBI,Lazio,15,15,0
392,Dc,KOULIBALY,Napoli,15,14,1
530,C;T,PELLEGRINI LO.,Roma,15,15,0
4285,C,ARTHUR,Juventus,15,15,0
4510,A,RAFAEL LEAO,Milan,15,14,1
376,W;T;A,VERDI,Torino,14,15,-1
536,W;A,POLITANO,Napoli,14,13,1
1934,Por,STRAKOSHA,Lazio,14,15,-1
247,Pc,PAVOLETTI,Cagliari,14,15,-1
1870,M;C,BARELLA,Inter,14,14,0
236,E;W,LAZOVIC,Verona,14,15,-1
2263,E,LAZZARI,Lazio,14,13,1
2759,Ds;Dc;E,CRISCITO,Genoa,14,15,-1
2130,Dd;E,HATEBOER,Atalanta,14,12,2
2164,Dd;Dc,MILENKOVIC,Fiorentina,14,14,0
286,Dc,BONUCCI,Juventus,14,13,1
4428,Dc,DE LIGT,Juventus,14,15,-1
459,Dc,MANOLAS,Napoli,14,13,1
2775,C;T,RUIZ,Napoli,14,14,0
1995,T,DJURICIC,Sassuolo,13,13,0
1997,Pc,SIMY,Crotone,13,13,0
2163,Pc,CORNELIUS,Parma,13,14,-1
123,Pc,INGLESE,Parma,13,14,-1
505,Pc,BONAZZOLI,Torino,13,13,0
652,Pc,KALINIC,Verona,13,13,0
644,M;C,PULGAR,Fiorentina,13,14,-1
1850,M;C,KESSIE',Milan,13,11,2
697,Dd;E,CUADRADO,Juventus,13,13,0
2707,Dd;Ds;E,YOUNG,Inter,13,13,0
152,C;T,ZIELINSKI,Napoli,13,12,1
4517,A,LOZANO,Napoli,13,11,2
474,A,GERVINHO,Parma,13,14,-1
1958,A,CAPRARI,Benevento,13,11,2
643,A,DEFREL,Sassuolo,13,11,2
345,A,KEITA B.,Sampdoria,13,13,0
704,W;A,PERISIC,Inter,12,13,-1
2692,W,CASTILLEJO,Milan,12,13,-1
406,W,CALLEJON,Fiorentina,12,12,0
610,Por,GOLLINI,Atalanta,12,13,-1
4419,Por,PAU LOPEZ,Roma,12,13,-1
2211,Por,SILVESTRI,Verona,12,11,1
4324,Pc,OKAKA,Udinese,12,14,-2
5292,Pc,LAMMERS,Atalanta,12,11,1
22,M;C,DE ROON,Atalanta,12,10,2
2816,Dd;E,DI LORENZO,Napoli,12,12,0
1852,Dd;Ds;E,SPINAZZOLA,Roma,12,11,1
2120,Dc,BASTONI,Inter,12,12,0
460,Dc,ROMAGNOLI,Milan,12,13,-1
2172,C;T,BARAK,Verona,12,12,0
632,C;T,ZACCAGNI,Verona,12,12,0
265,C,BROZOVIC,Inter,12,12,0
2166,C,BENTANCUR,Juventus,12,12,0
475,A,IAGO FALQUE,Benevento,12,14,-2
302,W;T,PEREYRA,Udinese,11,11,0
2119,W;A,DEULOFEU,Udinese,11,11,0
2472,T,RAMSEY,Juventus,11,10,1
1917,Por,DRAGOWSKI,Fiorentina,11,12,-1
509,Por,CONSIGLI,Sassuolo,11,10,1
2792,Por,MUSSO,Udinese,11,11,0
383,Pc,PETAGNA,Napoli,11,12,-1
315,Pc,ZAZA,Torino,11,12,-1
1943,Pc,NESTOROVSKI,Udinese,11,11,0
5012,Pc,MURIQI,Lazio,11,12,-1
662,Ds;E,ALEX SANDRO,Juventus,11,12,-1
695,Dc,TOLOI,Atalanta,11,12,-1
288,Dc,CHIELLINI,Juventus,11,11,0
2288,Dc,N'KOULOU,Torino,11,11,0
4245,Dc,SMALLING,Roma,11,11,0
1987,C;W,JANKTO,Sampdoria,11,12,-1
1978,C,SENSI,Inter,11,11,0
280,A,PALACIO,Bologna,11,10,1
245,A,PANDEV,Genoa,11,10,1
4886,W;T;A,PEREIRO,Cagliari,10,11,-1
184,W;T,BERNARDESCHI,Juventus,10,11,-1
2178,Por,CRAGNO,Cagliari,10,11,-1
2179,Por,SIRIGU,Torino,10,11,-1
2155,Pc,CUTRONE,Fiorentina,10,11,-1
4500,Pc,DI CARMINE,Verona,10,11,-1
472,Pc,DESTRO,Genoa,10,9,1
4514,M;C,NANDEZ,Cagliari,10,11,-1
4522,M;C,AMRABAT,Fiorentina,10,11,-1
58,M;C,DIAWARA,Roma,10,10,0
253,Dd;Dc;E,D'AMBROSIO,Inter,10,10,0
4422,Dd;Dc,TOMIYASU,Bologna,10,9,1
226,Dd;Dc,IZZO,Torino,10,11,-1
2181,Dc,PALOMINO,Atalanta,10,9,1
4331,Dc,IBANEZ,Roma,10,9,1
2296,Dc,MANCINI,Roma,10,10,0
4495,Dc,KUMBULLA,Roma,10,10,0
4479,C;T,ELMAS,Napoli,10,9,1
600,C;T,VERRE,Sampdoria,10,8,2
788,C,FREULER,Atalanta,10,10,0
234,C,KUCKA,Parma,10,12,-2
2008,C,LINETTY,Torino,10,11,-1
2839,W;A,SOTTIL,Cagliari,9,9,0
4884,W;A,CARLES PEREZ,Roma,9,9,0
2124,T,ZAJC,Genoa,9,10,-1
2038,Pc,PINAMONTI,Inter,9,10,-1
2196,Pc,GALABINOV,Spezia,9,4,5
5009,Pc,RIVIERE,Crotone,9,8,1
5311,Pc,SHOMURODOV,Genoa,9,9,0
5233,Pc,MAYORAL,Roma,9,9,0
2076,M;C,ROG,Cagliari,9,9,0
801,M;C,GAGLIARDINI,Inter,9,7,2
2818,M;C,BENNACER,Milan,9,9,0
4404,M;C,THORSBY,Sampdoria,9,9,0
2639,M,BAKAYOKO,Napoli,9,9,0
329,Ds;Dc,RADU,Lazio,9,9,0
73,Ds;Dc,GAGLIOLO,Parma,9,9,0
74,Dd;Ds;E,LETIZIA,Benevento,9,7,2
4426,Dd;Ds;E,TOLJAN,Sassuolo,9,8,1
2315,Dd;Dc;E,STRYGER LARSEN,Udinese,9,10,-1
550,Dd;Dc,MAKSIMOVIC,Napoli,9,9,0
787,Dc,DJIMSITI,Atalanta,9,9,0
2309,Dc,PEZZELLA GER.,Fiorentina,9,10,-1
2572,Dc,GODIN,Cagliari,9,9,0
4307,Dc,ROMERO,Atalanta,9,9,0
2633,Dc,KJAER,Milan,9,8,1
2784,Dc,COLLEY,Sampdoria,9,8,1
1895,Dc,FERRARI G.,Sassuolo,9,8,1
28,C;T,KURTIC,Parma,9,8,1
1882,A,SAU,Benevento,9,8,1
4992,A,GYASI,Spezia,9,9,0
4978,W;T;A,DAMSGAARD,Sampdoria,8,8,0
4415,W;A,SKOV OLSEN,Bologna,8,7,1
2826,W;A,PUSSETTO,Udinese,8,8,0
5328,T,GOJAK,Torino,8,8,0
4957,Por,MONTIPO',Benevento,8,7,1
133,Por,SKORUPSKI,Bologna,8,8,0
572,Por,MERET,Napoli,8,8,0
2468,Por,OSPINA,Napoli,8,8,0
159,Por,SEPE,Parma,8,9,-1
761,Por,AUDERO,Sampdoria,8,8,0
218,Por,PERIN,Genoa,8,8,0
311,Pc,LLORENTE,Napoli,8,9,-1
2209,M;C,LUCAS LEIVA,Lazio,8,9,-1
4423,M;C,HERNANI,Parma,8,6,2
2391,M;C,EKDAL,Sampdoria,8,8,0
4990,M;C,RICCI M.,Spezia,8,7,1
2011,M;C,MIGUEL VELOSO,Verona,8,8,0
2357,M;C,CYPRIEN,Parma,8,8,0
1851,E;W,MOLINA S.,Crotone,8,7,1
332,E;W,CANDREVA,Sampdoria,8,7,1
252,Ds;E,BIRAGHI,Fiorentina,8,8,0
2169,Ds;E,RODRIGUEZ R.,Torino,8,9,-1
4958,Ds;Dc,CALDIROLA,Benevento,8,6,2
2006,Dd;E,LIROLA,Fiorentina,8,8,0
546,Dd;E,BRUNO PERES,Roma,8,9,-1
4994,Dd;E,VOJVODA,Torino,8,8,0
487,Dd;E,DE SILVESTRI,Bologna,8,8,0
287,Dd;Ds;Dc,CACERES,Fiorentina,8,8,0
798,Dc,SKRINIAR,Inter,8,8,0
2758,Dc,GUNTER,Verona,8,7,1
428,C;T,BENALI,Crotone,8,9,-1
557,C;T,BENASSI,Verona,8,9,-1
2857,C;T,TRAORE' HJ.,Sassuolo,8,8,0
440,C,VIOLA,Benevento,8,9,-1
2379,C,RABIOT,Juventus,8,9,-1
4449,C,TONALI,Milan,8,8,0
4435,A,COLLEY E.,Verona,8,8,0
4970,A,MESSIAS,Crotone,8,8,0
1879,A,FARIAS,Spezia,8,9,-1
4892,W,SAELEMAEKERS,Milan,7,5,2
4249,T,PEREIRA A.,Lazio,7,8,-1
4393,M;C,SCHOUTEN,Bologna,7,6,1
526,M;C,DUNCAN,Fiorentina,7,7,0
779,M;C,CRISTANTE,Roma,7,8,-1
2825,M;C,BOURABIA,Sassuolo,7,6,1
4987,M;C,BARTOLOMEI,Spezia,7,7,0
4890,M;C,TAMEZE,Verona,7,6,1
4725,M,DEMME,Napoli,7,7,0
338,E;C,LULIC,Lazio,7,8,-1
633,E,FARES,Lazio,7,7,0
142,Ds;E,MARIO RUI,Napoli,7,8,-1
4530,Ds;E,KYRIAKOPOULOS,Sassuolo,7,6,1
706,Ds;E,ANSALDI,Torino,7,8,-1
4999,Ds;E,OUWEJAN,Udinese,7,5,2
244,Dd;E,GHIGLIONE,Genoa,7,6,1
554,Dd;E,ZAPPACOSTA,Genoa,7,6,1
4237,Dd;Ds;E,DANILO,Juventus,7,6,1
357,Dd;Ds;E,CALABRIA,Milan,7,5,2
140,Dd;Ds;E,HYSAJ,Napoli,7,7,0
2525,Dd;Ds;E,DARMIAN,Inter,7,8,-1
548,Dc,GLIK,Benevento,7,8,-1
2335,Dc,LUIZ FELIPE,Lazio,7,8,-1
1864,Dc,BRUNO ALVES,Parma,7,8,-1
4895,Dc,YOSHIDA,Sampdoria,7,7,0
4979,Dc,AYHAN,Sassuolo,7,7,0
224,Dc,DE MAIO,Udinese,7,6,1
2280,Dc,NUYTINCK,Udinese,7,8,-1
324,Dc,HOEDT,Lazio,7,7,0
4965,C,MARIN,Cagliari,7,7,0
2703,C,ADRIEN SILVA,Sampdoria,7,7,0
537,A,SANSONE,Bologna,7,8,-1
2325,A,KARAMOH,Parma,7,5,2
215,A,VERDE,Spezia,7,6,1
4681,W;T,LOPEZ M.,Sassuolo,6,6,0
4894,W;A,HARASLIN,Sassuolo,6,6,0
5310,W;A,HAUGE,Milan,6,6,0
150,T,SAPONARA,Fiorentina,6,7,-1
2743,Pc,SANTANDER,Bologna,6,7,-1
2304,Pc,SALCEDO E.,Verona,6,6,0
2213,M;C,CASSATA,Genoa,6,6,0
4330,M;C,LERAGER,Genoa,6,6,0
181,M;C,VECINO,Inter,6,7,-1
4973,M;C,MCKENNIE,Juventus,6,6,0
430,M;C,BRUGMAN,Parma,6,5,1
4501,M;C,OBIANG,Sassuolo,6,5,1
2789,M;C,MEITE',Torino,6,6,0
238,M,RINCON,Torino,6,5,1
2746,Ds;E,DIJKS,Bologna,6,7,-1
4421,Ds;E,AUGELLO,Sampdoria,6,7,-1
2318,Ds;E,ROGERIO,Sassuolo,6,6,0
5006,Dd;E,PICCINI,Atalanta,6,7,-1
4409,Dd;Ds;Dc,RRAHMANI,Napoli,6,7,-1
4521,Dd;Dc;E,MULDUR,Sassuolo,6,6,0
578,Dc,DANILO LAR.,Bologna,6,6,0
1866,Dc,CEPPITELLI,Cagliari,6,7,-1
4332,Dc,DEMIRAL,Juventus,6,6,0
2168,Dc,MUSACCHIO,Milan,6,7,-1
2355,Dc,MARLON,Sassuolo,6,7,-1
4982,Dc,ERLIC,Spezia,6,6,0
2788,Dc,BREMER,Torino,6,6,0
2171,Dc,LYANCO,Torino,6,6,0
4519,Dc,CETIN,Verona,6,5,1
2741,C;T,PESSINA,Atalanta,6,7,-1
5002,C;T,VULIC,Crotone,6,6,0
4869,C,DOMINGUEZ,Bologna,6,7,-1
4512,C,SCHONE,Genoa,6,7,-1
556,C,BASELLI,Torino,6,7,-1
5013,A,ASORO,Genoa,6,6,0
4963,W;A,INSIGNE R.,Benevento,5,6,-1
1889,Por,CORDAZ,Crotone,5,6,-1
5005,Por,ZOET,Spezia,5,6,-1
819,Pc,FAVILLI,Verona,5,4,1
115,M;C,HETEMAJ,Benevento,5,4,1
4975,M;C,ESCALANTE,Lazio,5,5,0
342,M;C,PAROLO,Lazio,5,5,0
4287,M;C,LOBOTKA,Napoli,5,5,0
434,M;C,JAJALO,Udinese,5,6,-1
20,M;C,CIGARINI,Crotone,5,5,0
5008,M;C,EDUARDO HENRIQUE,Crotone,5,5,0
272,M,MEDEL,Bologna,5,4,1
2302,M,BEHRAMI,Genoa,5,4,1
2188,E,MARUSIC,Lazio,5,4,1
5293,E,MOJICA,Atalanta,5,5,0
2728,Ds;E,PELLEGRINI LU.,Genoa,5,5,0
770,Ds;E,PEZZELLA GIU.,Parma,5,5,0
1868,Ds;E,MURRU,Torino,5,5,0
254,Ds;E,DIMARCO,Verona,5,4,1
256,Ds;Dc,JUAN JESUS,Roma,5,6,-1
790,Ds;Dc,SAMIR,Udinese,5,5,0
2104,Dd;E,BERESZYNSKI,Sampdoria,5,5,0
2141,Dd;E,DEPAOLI,Atalanta,5,6,-1
4983,Dd;E,FERRER,Spezia,5,5,0
423,Dd;E,RISPOLI,Crotone,5,5,0
262,Dd;Ds;E,SANTON,Roma,5,3,2
2083,Dd;Dc;E,BIRASCHI,Genoa,5,5,0
327,Dd;Dc;E,PATRIC,Lazio,5,4,1
2801,Dd;Dc,IACOPONI,Parma,5,7,-2
640,Dd;Dc,CHIRICHES,Sassuolo,5,5,0
2285,Dc,BANI,Genoa,5,6,-1
2871,Dc,KLAVAN,Cagliari,5,5,0
4374,Dc,WALUKIEWICZ,Cagliari,5,4,1
4967,Dc,GOLEMIC,Crotone,5,5,0
418,Dc,GOLDANIGA,Genoa,5,5,0
365,Dc,ZAPATA C.,Genoa,5,5,0
2062,Dc,BASTOS,Lazio,5,5,0
144,Dc,TONELLI,Sampdoria,5,6,-1
4412,Dc,RODRIGO BECAO,Udinese,5,6,-1
2192,Dc,BONIFAZI,Udinese,5,6,-1
5323,Dc,MARTINEZ QUARTA,Fiorentina,5,5,0
5327,Dc,OSORIO,Parma,5,5,0
5007,C;T,ILIC,Verona,5,4,1
627,C,IONITA,Benevento,5,5,0
27,C,GRASSI,Parma,5,4,1
4988,C,MAGGIORE,Spezia,5,5,0
172,C,BORJA VALERO,Fiorentina,5,4,1
179,C,PETRICCIONE,Crotone,5,5,0
4346,A,MILLICO,Torino,5,5,0
5004,A,FORESTIERI,Udinese,5,4,1
1998,A,PJACA,Genoa,5,3,2
4962,W;A,IMPROTA,Benevento,4,4,0
1839,W;A,EDERA,Torino,4,4,0
637,W,SILIGARDI,Crotone,4,4,0
2154,T;A,VIGNATO,Bologna,4,4,0
5317,T;A,BRUNETTA,Parma,4,4,0
41,Por,MIRANTE,Roma,4,1,3
305,M;C,STURARO,Genoa,4,4,0
170,M;C,BADELJ,Genoa,4,3,1
333,M;C,CATALDI,Lazio,4,5,-1
1933,M;C,MANDRAGORA,Udinese,4,5,-1
5329,M;C,MAKENGO,Udinese,4,4,0
118,M,RADOVANOVIC,Genoa,4,3,1
2392,M,WALACE,Udinese,4,5,-1
4881,Ds;E,CZYBORRA,Genoa,4,4,0
4323,Ds;E,ZEEGELAAR,Udinese,4,4,0
4414,Ds;Dc,DENSWIL,Bologna,4,4,0
4407,Ds;Dc,IGOR,Fiorentina,4,5,-1
4494,Ds;Dc,EMPEREUR,Verona,4,4,0
11,Dd;E,CONTI,Milan,4,5,-1
2860,Dd;E,MALCUIT,Napoli,4,4,0
141,Dd;E,LAURINI,Parma,4,4,0
2795,Dd;E,TER AVEST,Udinese,4,4,0
4997,Dd;E,RUEGG,Verona,4,4,0
4998,Dd;E,MOLINA N.,Udinese,4,4,0
630,Dd;E,SALA,Spezia,4,4,0
5326,Dd;E,BUSI,Parma,4,4,0
4242,Dd;Ds;E,DALOT,Milan,4,4,0
1869,Dd;Ds;Dc,PISACANE,Cagliari,4,5,-1
1891,Dd;Dc,CECCHERINI,Verona,4,4,0
1847,Dc,CALDARA,Atalanta,4,5,-1
2279,Dc,ROMAGNA,Sassuolo,4,5,-1
84,Dc,MARRONE,Crotone,4,5,-1
2016,Dc,FAZIO,Roma,4,5,-1
2769,Dc,MAGNANI,Verona,4,5,-1
5000,Dc,MAGALLAN,Crotone,4,5,-1
5307,Dc,VALENTI,Parma,4,5,-1
1915,C;W,TELLO,Benevento,4,5,-1
2744,C;T,SVANBERG,Bologna,4,4,0
4515,C;T,AGUDELO,Spezia,4,4,0
148,C;T,KRUNIC,Milan,4,5,-1
2264,C,MORA,Spezia,4,4,0
2195,A,OUNAS,Cagliari,4,5,-1
1982,W,PARIGINI,Genoa,3,3,0
2378,T,PASTORE,Roma,3,4,-1
611,Por,RAFAEL,Spezia,3,1,2
447,Pc,LA GUMINA,Sampdoria,3,4,-1
5011,Pc,DRAGUS,Crotone,3,3,0
2265,M;C,SCHIATTARELLA,Benevento,3,4,-1
374,M;C,POLI,Bologna,3,3,0
2854,M;C,BRADARIC,Cagliari,3,4,-1
1871,M;C,DEIOLA,Spezia,3,3,0
2659,M;C,DABO,Benevento,3,2,1
2804,M;C,SCOZZARELLA,Parma,3,4,-1
2855,M;C,VIEIRA,Verona,3,4,-1
4327,M,OLIVA,Cagliari,3,3,0
2739,Ds;E,RECA,Crotone,3,3,0
2653,Ds;E,LYKOGIANNIS,Cagliari,3,2,1
1950,Ds;E,MAZZOTTA,Crotone,3,4,-1
390,Ds;E,GHOULAM,Napoli,3,3,0
4984,Ds;E,RAMOS,Spezia,3,3,0
1979,Ds;E,BARRECA,Fiorentina,3,3,0
517,Ds;Dc,DELL'ORCO,Spezia,3,4,-1
2252,Ds;Dc,MARCHIZZA,Spezia,3,3,0
521,Ds;Dc,PELUSO,Sassuolo,3,4,-1
2116,Dd;E,FARAGO',Cagliari,3,4,-1
4461,Dd;E,ZAPPA,Cagliari,3,3,0
2180,Dd;E,KARSDORP,Roma,3,3,0
729,Dd;E,PEREIRA P.,Crotone,3,3,0
106,Dd;Ds;E,MATTIELLO,Spezia,3,4,-1
2174,Dd;Ds;E,VENUTI,Fiorentina,3,4,-1
5300,Dd;Ds;E,HICKEY,Bologna,3,2,1
4899,Dd;Dc;E,SINGO,Torino,3,3,0
15,Dd;Dc,MASIELLO,Genoa,3,4,-1
4960,Dc,TUIA,Benevento,3,3,0
4511,Dc,DUARTE,Milan,3,3,0
4401,Dc,GABBIA,Milan,3,1,2
4403,Dc,CHABOT,Spezia,3,2,1
4493,Dc,DAWIDOWICZ,Verona,3,4,-1
4934,Dc,LOVATO,Verona,3,1,2
2286,C;T,CROCIATA,Crotone,3,4,-1
5287,C;T,ARSLAN,Udinese,3,3,0
299,C,KHEDIRA,Juventus,3,3,0
2009,C,LUKIC,Torino,3,3,0
4995,C,SEGRE,Torino,3,3,0
5322,A,MIHAILA,Parma,3,3,0
2773,W,SPROCATI,Parma,2,2,0
4,Por,SPORTIELLO,Atalanta,2,1,1
2853,Pc,MONCINI,Benevento,2,2,0
306,Pc,CERRI,Cagliari,2,3,-1
4923,Pc,COLOMBO,Milan,2,1,1
4371,Pc,RASPADORI,Sassuolo,2,3,-1
4986,M;C,ACAMPORA,Spezia,2,1,1
589,M;C,BADU,Verona,2,3,-1
5286,M;C,AKPA AKPRO,Lazio,2,1,1
2144,M;C,COULIBALY,Udinese,2,1,1
5312,M;C,LEO' SENA,Spezia,2,2,0
528,M,MAGNANELLI,Sassuolo,2,3,-1
5319,M,SOHM,Parma,2,2,0
4959,Ds;E,FOULON,Benevento,2,1,1
4946,Ds;E,FRABOTTA,Juventus,2,1,1
134,Ds;Dc,BARBA,Benevento,2,2,0
393,Ds;Dc,LUPERTO,Crotone,2,2,0
2869,Ds;Dc,DJIDJI,Crotone,2,2,0
394,Dd;E,MAGGIO,Benevento,2,2,0
4985,Dd;E,VIGNALI,Spezia,2,3,-1
50,Dd;Ds;E,MBAYE,Bologna,2,3,-1
45,Dd;Dc,FERRARI A.,Sampdoria,2,3,-1
4888,Dc,SUTALO,Atalanta,2,3,-1
2143,Dc,CUOMO,Crotone,2,3,-1
4397,Dc,VAVRO,Lazio,2,3,-1
454,Dc,CAPRADOSSI,Spezia,2,3,-1
425,Dc,TERZI,Spezia,2,3,-1
5010,Dc,ISMAJLI,Spezia,2,3,-1
2334,C;W,LERIS,Sampdoria,2,2,0
4989,C;W,MASTINU,Spezia,2,3,-1
5290,C;T,ESTEVEZ,Spezia,2,3,-1
4968,C,GOMELT,Crotone,2,1,1
2316,C,ZANELLATO,Crotone,2,2,0
4921,C,ASKILDSEN,Sampdoria,2,2,0
2121,C,MELEGONI,Genoa,2,1,1
2725,C,CALIGARA,Cagliari,2,1,1
5298,C,POBEGA,Spezia,2,1,1
5297,A,LUVUMBO,Cagliari,2,2,0
5318,W,TRAMONI M.,Cagliari,1,1,0
4896,T;A,MALDINI,Milan,1,1,0
4353,T;A,MONTIEL,Fiorentina,1,1,0
4431,Por,CARNESECCHI,Atalanta,1,1,0
2297,Por,ROSSI F.,Atalanta,1,1,0
4955,Por,GORI P.,Benevento,1,1,0
4956,Por,MANFREDINI,Benevento,1,1,0
4883,Por,BREZA,Bologna,1,1,0
40,Por,DA COSTA,Bologna,1,1,0
4964,Por,VICARIO,Cagliari,1,1,0
1946,Por,ARESTI,Cagliari,1,1,0
4929,Por,CIOCCI,Cagliari,1,1,0
1890,Por,FESTA,Crotone,1,1,0
4351,Por,BRANCOLINI,Fiorentina,1,1,0
2815,Por,TERRACCIANO,Fiorentina,1,1,0
318,Por,MARCHETTI,Genoa,1,1,0
1843,Por,RADU I.,Inter,1,1,0
282,Por,BUFFON,Juventus,1,1,0
1930,Por,PINSOGLIO,Juventus,1,1,0
2770,Por,PROTO,Lazio,1,1,0
387,Por,REINA,Lazio,1,1,0
216,Por,DONNARUMMA AN.,Milan,1,1,0
2845,Por,CONTINI,Napoli,1,1,0
412,Por,COLOMBI,Parma,1,1,0
4977,Por,RAVAGLIA,Sampdoria,1,1,0
510,Por,PEGOLO,Sassuolo,1,1,0
4867,Por,TURATI,Sassuolo,1,1,0
4981,Por,KRAPIKAS,Spezia,1,1,0
2790,Por,ROSATI,Torino,1,1,0
220,Por,UJKANI,Torino,1,1,0
2271,Por,NICOLAS,Udinese,1,1,0
4491,Por,BERARDI A.,Verona,1,1,0
4996,Por,PANDUR,Verona,1,1,0
160,Por,TATARUSANU,Milan,1,1,0
543,Por,PADELLI,Inter,1,1,0
5289,Por,CRESPI,Crotone,1,1,0
1921,Por,ZIMA,Genoa,1,1,0
5304,Por,BOER,Roma,1,1,0
4523,Por,AVOGADRI,Sampdoria,1,1,0
5306,Por,ALIA,Lazio,1,1,0
5320,Por,PALEARI,Genoa,1,1,0
2814,Por,PROVEDEL,Spezia,1,1,0
4520,Por,LETICA,Sampdoria,1,1,0
574,Por,SCUFFET,Udinese,1,1,0
2798,Por,DINI,Parma,1,1,0
2170,Por,MILINKOVIC-SAVIC V.,Torino,1,1,0
5333,Por,GASPARINI,Udinese,1,1,0
4359,Pc,PICCOLI,Spezia,1,1,0
2137,Pc,SCAMACCA,Genoa,1,1,0
4387,Pc,ADORANTE,Parma,1,1,0
2244,M;C,DEL PINTO,Benevento,1,1,0
2726,M;C,DANZI,Verona,1,1,0
5331,M;C,BASIT,Benevento,1,1,0
4459,M;C,ROVELLA,Genoa,1,1,0
4969,E;W,MUSTACCHIO,Crotone,1,1,0
4390,E,ANDERSON D.,Lazio,1,1,0
4406,Ds;E,TRIPALDELLI,Cagliari,1,1,0
4945,Ds;E,CALAFIORI,Roma,1,1,0
1876,Ds;E,PAJAC,Cagliari,1,1,0
5332,Ds;E,BASTONI S.,Spezia,1,1,0
490,Ds;Dc;E,REGINI,Sampdoria,1,1,0
4925,Ds;Dc,CARBONI,Cagliari,1,1,0
2724,Ds;Dc,BUONGIORNO,Torino,1,1,0
4454,Dd;E,PINNA,Cagliari,1,1,0
519,Dd;E,GAZZOLA,Parma,1,1,0
4366,Dd;Ds;Dc,ARMINI,Lazio,1,1,0
4976,Dd;Dc,KALULU,Milan,1,1,0
2745,Dd;Dc,CALABRESI,Bologna,1,1,0
4961,Dc,VOLTA,Benevento,1,1,0
78,Dc,SPOLLI,Crotone,1,1,0
261,Dc,RANOCCHIA,Inter,1,2,-1
4917,Dc,PRODL,Udinese,1,2,-1
5316,Dc,AMIONE,Verona,1,1,0
4950,Dc,DALLE MURA,Fiorentina,1,1,0
4487,Dc,FERIGRA,Torino,1,1,0
2107,C;W;T,KIYINE,Lazio,1,2,-1
4919,C;T,BALDURSSON,Bologna,1,1,0
400,C;T,DEZI,Parma,1,1,0
2835,C;T,KINGSLEY,Bologna,1,1,0
4411,C,AGOUME,Spezia,1,2,-1
4885,C,VILLAR,Roma,1,2,-1
4953,C,PALUMBO,Udinese,1,1,0
4349,C,NICOLUSSI CAVIGLIA,Parma,1,1,0
4370,C,PORTANOVA,Juventus,1,1,0
4862,A,TRAORE' AM.,Atalanta,1,1,0
5303,A,MALES,Genoa,1,1,0
2013,A,RICCI F.,Sassuolo,1,1,0
4335,A,SCHIAPPACASSE,Sassuolo,1,1,0
4938,A,MORO,Lazio,1,1,0